72,123,123,123,123,123,123,123,123,123,123,123,123,123,123,123,123,123,123,123,123,123,123,123,123,123,123,123,123,123,123,123
72,192,192,192,192,192,192,72,33,33,33,72,200,200,200,200,200,216,216,216,216,72,200,200,192,192,192,192,192,192,192,72
72,194,194,194,194,194,194,72,33,15,214,72,200,216,216,216,200,216,216,216,214,72,216,216,216,216,216,216,216,216,216,72
72,33,33,33,33,33,33,124,33,33,33,72,200,216,189,216,124,216,216,216,216,72,141,141,141,141,192,192,192,192,216,72
72,33,33,33,33,33,33,124,33,33,33,72,200,216,216,216,200,216,216,216,216,72,216,216,216,216,216,216,216,216,216,72
72,194,194,194,194,194,194,72,33,33,33,72,200,216,216,216,200,216,216,216,216,72,192,143,143,143,68,192,192,192,216,72
72,167,167,167,167,167,167,72,33,33,33,72,200,200,200,200,200,216,216,216,216,72,216,216,216,216,216,216,216,216,216,72
72,123,123,123,123,123,123,16,149,16,123,123,123,123,123,123,123,123,16,149,16,72,123,123,123,123,123,123,16,149,149,16
72,200,217,72,216,16,178,33,33,33,178,16,33,33,33,33,33,33,33,33,33,33,33,33,33,33,33,33,16,216,216,72
72,109,217,17,216,124,33,33,38,33,33,124,33,33,33,33,33,33,33,33,33,33,33,33,33,33,33,33,124,216,216,72
72,200,217,72,216,16,178,33,33,33,178,16,33,33,33,33,33,33,33,33,33,33,33,33,33,33,33,33,16,216,216,72
72,123,123,123,123,123,123,16,149,16,123,123,123,123,123,123,123,123,16,149,16,123,123,16,149,16,123,123,16,149,149,16
72,33,33,33,33,33,33,33,33,33,33,72,33,33,33,33,33,33,33,33,33,72,33,33,33,33,72,192,216,216,216,72
72,33,214,33,214,33,214,33,214,33,33,72,33,33,33,33,214,33,214,33,214,72,33,33,214,33,72,194,216,216,216,72
72,33,33,33,33,33,33,33,33,33,33,72,33,33,33,33,214,33,214,33,214,72,33,15,214,33,72,216,216,216,216,72
72,33,214,33,214,33,214,33,214,33,33,72,33,15,33,33,214,33,214,33,214,72,33,33,214,33,72,216,15,216,216,72
72,33,33,33,33,33,33,33,15,33,33,72,42,42,42,33,214,33,214,33,214,72,33,33,33,33,72,216,216,216,214,72
72,123,123,123,123,123,123,123,123,123,123,123,16,149,16,123,123,123,123,123,123,123,123,123,123,123,123,58,58,123,123,123
72,33,33,33,33,33,33,33,33,33,33,33,33,33,33,72,178,6,4,6,6,6,6,6,6,6,156,83,83,202,6,6
72,33,33,33,33,33,33,33,33,33,33,33,33,33,6,72,6,7,7,156,7,7,4,7,7,7,81,83,83,81,6,156
72,33,33,33,33,33,33,33,82,33,33,33,33,6,4,165,6,7,6,4,6,6,7,7,6,7,156,83,83,202,6,6
72,33,82,33,33,33,33,33,33,33,33,33,33,33,6,72,6,7,7,6,6,153,156,6,6,7,81,83,83,81,6,6
72,33,33,33,33,33,33,33,33,33,33,33,33,6,6,72,6,6,4,7,7,4,7,7,81,81,156,83,83,202,81,81
72,33,33,33,33,4,33,33,33,33,4,33,6,6,6,165,6,153,7,83,83,83,83,83,83,83,83,83,83,83,83,83
72,33,33,33,33,33,33,90,33,33,33,6,6,4,6,72,6,156,7,83,131,59,59,59,59,59,59,59,59,59,202,83
72,33,33,6,33,82,33,33,33,33,6,33,6,33,33,72,6,6,6,83,59,59,59,59,59,59,59,59,59,59,59,83
72,33,33,33,33,33,33,33,33,33,33,33,33,6,33,72,6,7,4,83,131,59,59,59,59,59,59,59,59,59,202,83
72,33,33,33,33,33,65,33,6,33,4,33,33,33,33,72,6,7,7,83,59,59,59,116,166,142,117,117,93,59,59,83
72,33,33,4,33,33,33,33,33,33,33,33,33,33,33,72,6,7,6,83,131,59,59,66,191,42,18,42,118,143,202,83
72,33,33,33,33,33,33,33,33,33,33,82,33,33,33,72,6,7,4,83,59,59,59,91,141,67,43,92,68,59,59,83
72,33,33,33,33,33,33,33,33,33,33,33,33,33,33,72,6,178,7,83,131,59,59,59,59,15,59,59,59,59,202,83
72,123,123,123,123,123,123,123,123,123,123,123,123,123,123,72,6,4,7,83,83,83,83,83,83,83,83,83,83,83,83,83
